{
  "levels": [
    {
      "id": 1,
      "faces": {
        "front": [
          "0000  0000",
          "0        0",
          "0        0",
          "0        0",
          "0        0",
          "0        0",
          "0000000000",
          "0       ^0",
          "0        0",
          "0000  0000"
        ],
        "top": [
          "0000  0000",
          "0        0",
          "0 000000 0",
          "0  0000  0",
          "0   00   0",
          "0        0",
          "0        0",
          "0        0",
          "0        0",
          "0000  0000"
        ],
        "left": [
          "0000000000",
          "0000000000",
          "0000000000",
          "0000000000",
          "0000000000",
          "0000000000",
          "0000000000",
          "0000000000",
          "0000000000",
          "0000000000"
        ],
        "right": [
          "0000000000",
          "0000000000",
          "0000000000",
          "0000000000",
          "0000000000",
          "0000000000",
          "0000000000",
          "0000000000",
          "0000000000",
          "0000000000"
        ],
        "bottom": [
          "0000  0000",
          "0        0",
          "0        0",
          "0        0",
          "0        0",
          "0   00   0",
          "0        0",
          "0        0",
          "0        0",
          "0000  0000"
        ],
        "back": [
          "0000  0000",
          "00      00",
          "0        0",
          "0  0  0  0",
          "0   00   0",
          "0   00   0",
          "0  0  0  0",
          "0        0",
          "00      00",
          "0000  0000"
        ]
      }
    },
    {
      "id": 2,
      "faces": {
        "front": [
          "0000000  0",
          "0     0  0",
          "0     0  0",
          "0     0  0",
          "      0  0",
          "      0  0",
          "0000000  0",
          "0000000  0",
          "0^       0",
          "0000000000"
        ],
        "top": [
          "0000000000",
          "   0     0",
          "   0  0  0",
          "0  0  0  0",
          "0  0  0  0",
          "0     0  0",
          "0000000  0",
          "0000000  0",
          "0000000  0",
          "0000000  0"
        ],
        "left": [
          "0  0000000",
          "0  0000000",
          "0  0000000",
          "0  0000000",
          "0         ",
          "0         ",
          "0000000000",
          "0000000000",
          "0000000000",
          "0000000000"
        ],
        "right": [
          "0000000000",
          "0000000000",
          "0000000000",
          "0000000000",
          "0000000000",
          "0000000000",
          "0000000000",
          "0000000000",
          "0000000000",
          "0000000000"
        ],
        "bottom": [
          "0000000000",
          "0000000000",
          "0000000000",
          "0000000000",
          "0000000000",
          "0000000000",
          "0000000000",
          "0000000000",
          "0000000000",
          "0000000000"
        ],
        "back": [
          "0000000000",
          "0000000000",
          "0000000000",
          "0000000000",
          "0000000000",
          "0000000000",
          "0000000000",
          "0000000000",
          "0000000000",
          "0000000000"
        ]
      }
    },
    {
      "id": 3,
      "faces": {
        "front": [
          "000 000000",
          "0^ #000000",
          "000 000000",
          "     00000",
          "      #  0",
          "      0   ",
          "0#    0   ",
          "0     0000",
          "         0",
          "      #  0"
        ],
        "top": [
          "0 00000000",
          "0 0?     0",
          "0 000000 0",
          "0        0",
          "0        0",
          "0        0",
          "0        0",
          "000      0",
          "  #      0",
          "000 000000"
        ],
        "left": [
          "00000000 0",
          "0      0 0",
          "0      0 0",
          "0     0   ",
          "       000",
          "0         ",
          "0         ",
          "0        0",
          "0        0",
          "0000000000"
        ],
        "right": [
          "0000000000",
          "0        0",
          "0        0",
          "0        0",
          "0         ",
          "         0",
          "0        0",
          "0        0",
          "0        0",
          "0000000000"
        ],
        "bottom": [
          "000000000G",
          "0B       0",
          "0        0",
          "0        0",
          "0        0",
          "0   00   0",
          "0        0",
          "0        0",
          "0        0",
          "000000 000"
        ],
        "back": [
          "0 00000000",
          "0 0     00",
          "0        0",
          "0        0",
          "       0 #",
          "0   000  0",
          "0  0  0  0",
          "0 0      0",
          "0 0     00",
          "000000 000"
        ]
      }
    },
    {
      "id": 4,
      "faces": {
        "front": [
          "00+0000000",
          "++ 000   +",
          "+++ ^0  00",
          "+  000  00",
          "+    0  00",
          "+0  00  00",
          "+0  0   00",
          "++  0   ++",
          "00000+0000",
          "00000+0000"
        ],
        "top": [
          "00000+0000",
          "++++++++++",
          "00000+0000",
          "000   0000",
          "+  +++0000",
          "00+    000",
          "00+    000",
          "00+    000",
          "00++++++++",
          "00+0000000"
        ],
        "left": [
          "0+00+00000",
          "0+00+00000",
          "0+++++++++",
          "0000+00000",
          "00   +++++",
          "0000 00000",
          "0000+00000",
          "++++++++++",
          "00+0000000",
          "00+0000000"
        ],
        "right": [
          "0+000000+0",
          "++0      0",
          "0+      00",
          "0+      00",
          "0+++++++++",
          "0+0     00",
          "0+00+00000",
          "++++++++++",
          "0000+00+00",
          "0000+00+00"
        ],
        "bottom": [
          "00000+0000",
          "00000+0000",
          "00000+0000",
          "00000+0000",
          "00++++++++",
          "00+00+0000",
          "00+00+0000",
          "++++++++++",
          "00+0000000",
          "00+0000000"
        ],
        "back": [
          "00000+0000",
          "0000  0000",
          "00  0 0000",
          "0++++ 0000",
          "0+++++++++",
          "0++   0000",
          "0++   0000",
          "++++++++++",
          "00+0000000",
          "00+0000000"
        ]
      }
    }
  ]
}