000000000G
0B       0
0        0
0        0
0        0
0   00   0
0        0
0        0
0        0
000000 000