00000+0000
0000  0000
00  0 0000
0++++ 0000
0+++++++++
0++   0000
0++   0000
++++++++++
00+0000000
00+0000000