0+00+00000
0+00+00000
0+++++++++
0000+00000
00   +++++
0000 00000
0000+00000
++++++++++
00+0000000
00+0000000