00000+0000
++++++++++
00000+0000
000   0000
+  +++0000
00+    000
00+    000
00+    000
00++++++++
00+0000000